64 89
350 150

57 57 57 57 57 57 57 57 57 57 57 57 57 57 57 57 57 57 57 57 57 57 57 57 57 57 57 57 57 57 57 57 57 57 57 57 57 57 57 57 57 57 57 57 57 57 57 57 57 57 57 57 57 57 57 57 57 57 57 57 57 57 57 57                                
57 57 57 57 57 57 57 57 57 57 57 57 57 57 57 57 57 57 57 57 57 57 57 57 57 57 57 57 57 57 57 57 57 57 57 57 57 57 57 57 57 57 57 57 57 57 57 57 57 57 57 57 57 57 57 57 57 57 57 57 57 57 57 57                                
57 57 57 57 57 57 57 57 57 57 57 57 57 57 57 57 57 57 57 57 57 57 57 57 57 57 57 57 57 57 57 57 57 57 57 57 57 57 57 57 57 57 57 57 57 57 57 57 57 57 57 57 57 57 57 57 57 57 57 57 57 57 57 57                                
57 57 57 57 57 57 57 57 57 11 12 12 12 13 57 57 57 57 57 57 57 57 57 57 57 57 57 57 57 57 57 85 86 86 86 86 86 86 87 57 57 57 57 57 57 57 57 57 57 57 57 57 57 57 57 57 57 57 57 57 57 57 57 57                                
57 57 57 57 57 57 57 57 57 16 17 17 17 18 57 57 57 57 57 57 57 57 57 57 57 57 57 57 57 57 57 88 89 89 89 89 89 89 90 57 57 57 57 57 57 57 57 57 57 57 57 57 57 57 57 57 57 57 57 57 57 57 57 57                                
57 57 57 57 57 57 57 57 57 20 21 21 21 22 57 57 57 57 57 57 57 57 57 57 57 57 57 57 57 57 57 40 40 40 40 40 40 40 40 57 57 57 57 57 57 57 57 57 57 57 57 57 57 57 57 57 57 57 57 57 57 57 57 57                                
57 57 57 57 57 57 57 57 57 23 19 19 19 24 57 57 57 57 57 57 57 57 57 57 57 57 57 57 57 57 57 40 40 40 40 40 40 40 40 57 57 57 57 57 57 57 57 57 57 57 57 57 57 57 57 57 57 57 57 57 57 57 57 57                                
57 57 57 57 57 57 57 57 57 23 19 19 19 24 57 57 57 57 57 57 57 57 57 57 57 57 57 57 57 57 57 40 40 40 40 40 40 40 40 57 57 57 57 57 57 57 57 57 57 57 57 57 57 57 57 57 57 57 57 57 57 57 57 57                                
57 57 57 57 57 57 57 57 57 23 19 19 19 24 57 57 57 57 57 57 57 57 57 57 57 57 57 57 57 57 57 40 40 40 40 40 40 40 40 57 57 57 57 57 57 57 57 57 57 57 57 57 57 57 57 57 57 57 57 57 57 57 57 57                                
57 57 57 11 12 12 12 12 13 23 19 19 19 24 11 12 12 12 12 13 57 57 57 57 57 57 57 57 57 57 57 40 40 40 40 40 40 40 40 57 57 57 57 57 57 57 57 57 57 57 57 57 57 57 57 57 57 57 57 57 57 57 57 57                                
57 57 57 16 17 17 17 17 18 28 27 19 27 29 16 17 17 17 17 18 57 57 57 57 57 57 57 57 57 57 57 57 57 57 91 91 57 57 57 57 57 57 57 57 57 57 57 57 57 57 57 57 57 57 57 57 57 57 57 57 57 57 57 57                                
57 57 57 20 21 21 21 21 21 19 19 19 19 19 21 21 21 21 21 22 57 57 57 57 57 57 57 57 57 57 57 57 57 57 57 57 57 57 57 57 57 57 57 57 57 57 57 57 57 57 57 57 57 57 57 57 57 57 57 57 57 57 57 57                                
57 57 57 23 19 19 19 19 19 19 19 19 19 19 19 19 19 19 19 24 57 57 57 57 57 57 57 57 57 57 57 57 57 57 57 57 57 57 57 57 57 57 57 57 57 57 57 57 57 57 57 57 57 57 57 57 57 57 57 57 57 57 57 57                                
57 57 57 23 19 19 19 19 19 19 19 19 19 19 19 19 19 19 19 24 57 57 57 57 57 57 57 57 57 57 57 57 57 57 57 57 57 57 57 57 57 57 57 57 57 57 57 57 57 57 57 57 57 57 57 57 57 57 57 57 57 57 57 57                                
57 57 57 23 19 19 19 19 19 19 19 19 19 19 19 19 19 19 19 24 57 57 57 57 57 57 57 57 57 57 57 57 57 57 57 57 57 57 57 57 57 57 57 57 57 57 57 57 57 57 57 57 57 57 57 57 57 57 57 57 57 57 57 57                                
57 57 57 25 26 26 26 26 26 26 26 26 26 26 26 26 26 26 26 109 57 57 57 57 57 57 57 57 57 57 57 57 57 57 57 57 57 57 57 57 57 57 57 57 57 57 57 57 57 57 57 57 57 57 57 57 57 57 57 57 57 57 57 57                                
57 57 57 57 57 57 57 57 57 57 91 91 91 57 57 57 57 57 57 57 57 57 57 57 57 57 57 57 57 57 57 57 57 57 57 57 57 57 57 57 57 57 57 57 57 57 57 57 57 57 57 57 57 57 57 57 57 57 57 57 57 57 57 57                                
57 57 57 57 57 57 57 57 57 57 57 57 57 57 57 57 57 57 57 57 57 57 57 57 57 57 57 57 57 57 57 57 57 57 57 57 57 57 57 57 57 57 57 57 57 57 57 57 57 57 57 57 57 57 57 57 57 57 57 57 57 57 57 57                                
57 57 57 57 57 57 57 57 57 57 57 57 57 57 57 57 57 57 57 57 57 57 57 57 57 57 57 57 57 57 57 57 57 57 57 57 57 57 57 57 57 57 57 57 57 57 57 57 57 57 57 57 57 57 57 57 57 57 57 57 57 57 57 57                                
57 57 57 57 57 57 57 57 57 57 57 57 57 57 57 57 57 57 57 57 57 57 57 57 57 57 57 57 57 57 57 57 57 57 57 57 57 57 57 57 57 57 57 57 57 57 57 57 57 57 57 57 57 57 57 57 57 57 57 57 57 57 57 57                                
57 57 57 57 57 57 57 57 57 57 57 57 57 57 57 57 57 57 57 57 57 57 57 57 57 57 57 57 57 57 57 57 57 57 57 57 57 57 57 57 57 57 57 57 57 57 57 57 57 57 57 57 57 57 57 57 57 57 57 57 57 57 57 57                                
57 57 57 57 57 57 57 57 57 57 57 57 57 57 57 57 57 57 57 57 57 57 57 57 57 57 57 57 57 57 57 57 57 57 57 57 57 57 57 57 57 57 57 57 57 57 57 57 57 57 57 57 57 57 57 57 57 57 57 57 57 57 57 57                                
57 57 57 57 57 57 57 57 57 57 57 57 57 57 57 57 57 57 57 57 57 57 57 57 57 57 57 57 57 57 57 57 57 57 57 57 57 57 57 57 57 57 57 57 57 57 57 57 57 57 57 57 57 57 57 57 57 57 57 57 57 57 57 57                                
57 57 57 57 57 57 57 57 57 57 57 57 57 57 57 57 57 57 57 57 57 57 57 57 57 57 57 57 57 57 57 57 57 57 57 57 57 57 57 57 57 57 57 57 57 57 57 57 57 57 57 57 57 57 57 57 57 57 57 57 57 57 57 57                                
57 57 57 57 57 57 57 57 57 57 57 57 57 57 57 57 57 57 57 57 57 57 57 57 57 57 57 57 57 57 57 57 57 57 57 57 57 57 57 57 57 57 57 57 57 57 57 57 57 57 57 57 57 57 57 57 57 57 57 57 57 57 57 57                                
57 57 57 57 57 57 57 57 57 57 57 57 57 57 57 57 57 57 57 57 57 57 57 57 57 57 57 57 57 57 57 57 57 57 57 57 57 57 57 57 57 57 57 57 57 57 57 57 57 57 57 57 57 57 57 57 57 57 57 57 57 57 57 57                                
57 57 57 57 57 57 57 57 57 57 57 57 57 57 57 57 57 57 57 57 57 57 57 57 57 57 57 57 57 57 57 57 57 57 57 57 57 57 57 57 57 57 57 57 57 57 57 57 57 57 57 57 57 57 57 57 57 57 57 57 57 57 57 57                                
57 57 57 57 57 57 57 57 57 57 57 57 57 57 57 57 57 57 57 57 57 57 57 57 57 57 57 57 57 57 57 57 57 57 57 57 57 57 57 57 57 57 57 57 57 57 57 57 57 57 57 57 57 57 57 57 57 57 57 57 57 57 57 57                                
57 57 57 57 57 57 57 57 57 57 57 57 57 57 57 57 57 57 57 57 57 57 57 57 57 57 57 57 57 57 57 57 57 57 57 57 57 57 57 57 57 57 57 57 57 57 57 57 57 57 57 57 57 57 57 57 57 57 57 57 57 57 57 57                                
57 57 57 57 57 57 57 57 57 57 57 57 57 57 57 57 57 57 57 57 57 57 57 57 57 57 57 57 57 57 57 57 57 57 57 57 57 57 57 57 57 57 57 57 57 57 57 57 57 57 57 57 57 57 57 57 57 57 57 57 57 57 57 57                                
57 57 57 57 57 57 57 57 57 57 57 57 57 57 57 57 57 57 57 57 57 57 57 57 57 57 57 57 57 57 57 57 57 57 57 57 57 57 57 57 57 57 57 57 57 57 57 57 57 57 57 57 57 57 57 57 57 57 57 57 57 57 57 57                                
57 57 57 57 57 57 57 57 57 57 57 57 57 57 57 57 57 57 57 57 57 57 57 57 57 57 57 57 57 57 57 57 57 57 57 57 57 57 57 57 57 57 57 57 57 57 57 57 57 57 57 57 57 57 57 57 57 57 57 57 57 57 57 57                                
57 57 57 57 57 57 57 57 57 57 57 57 57 57 57 57 57 57 57 57 57 57 57 57 57 57 57 57 57 57 57 57 57 57 57 57 57 57 57 57 57 57 57 57 57 57 57 57 57 57 57 57 57 57 57 57 57 57 57 57 57 57 57 57                                
5 5 5 5 5 5 5 5 5 5 5 5 5 5 5 5 5 5 5 5 5 5 5 5 5 5 5 5 5 5 5 64 60 60 60 60 60 60 60 60 60 60 60 60 65 35 5 5 5 5 5 5 5 5 5 5 5 5 5 5 5 5 5 5                                
5 5 5 5 5 5 5 5 5 5 5 5 5 5 5 5 5 5 5 5 5 5 5 5 5 5 5 5 5 5 5 64 60 60 60 60 60 60 60 60 60 60 60 60 65 35 5 5 5 5 5 5 5 5 5 5 5 5 5 5 5 5 5 5                                
5 5 5 5 5 5 5 5 5 5 5 5 5 5 5 5 5 5 5 5 5 5 5 5 5 5 5 5 5 5 5 64 60 60 60 60 60 60 60 60 60 60 60 60 65 35 5 5 5 5 5 5 5 5 5 5 5 5 5 5 5 5 5 5                                
5 5 5 5 5 5 5 5 5 5 5 5 5 5 5 5 5 5 5 5 5 5 5 5 5 5 5 5 5 5 5 64 60 60 60 60 60 60 60 60 60 60 60 60 65 35 5 5 5 5 5 5 5 5 5 5 5 5 5 5 5 5 5 5                                
5 5 5 5 5 5 5 5 5 5 5 5 5 5 5 5 5 5 5 5 5 5 5 5 5 5 5 5 5 5 5 64 60 60 60 60 60 60 60 60 60 60 60 60 65 35 5 5 5 5 5 5 5 5 5 5 5 5 5 5 5 5 5 5                                
5 5 5 5 5 5 5 5 5 5 5 5 5 5 5 5 5 5 5 5 5 5 5 5 5 5 5 5 5 5 5 64 60 60 60 60 60 60 60 60 60 60 60 60 65 35 5 5 5 5 5 5 5 5 5 5 5 5 5 5 5 5 5 5                                
5 5 5 5 5 5 5 5 5 5 5 5 5 5 5 5 5 5 5 5 5 5 5 5 5 5 5 5 5 5 5 64 60 60 60 60 60 60 60 60 60 60 60 60 65 35 5 5 5 5 5 5 5 5 5 5 5 5 5 5 5 5 5 5                                
5 5 5 5 5 5 5 5 5 5 5 5 5 5 5 5 5 5 5 5 5 5 5 5 5 5 5 5 5 5 5 66 67 67 67 67 67 67 67 67 67 67 67 67 68 35 5 5 5 5 5 5 5 5 5 5 5 5 5 5 5 5 5 5                                
5 5 5 5 32 33 33 33 33 33 33 33 33 33 33 33 33 33 33 33 33 33 33 33 33 33 33 33 39 5 5 5 5 5 5 5 5 5 5 5 5 5 5 5 5 35 5 5 5 5 5 5 5 5 5 5 5 5 5 5 5 5 5 5                                
5 5 5 5 35 49 47 47 47 47 47 47 47 47 47 47 47 47 47 47 47 47 47 47 47 47 47 47 47 47 47 47 47 47 47 47 47 47 47 47 47 51 5 5 5 35 38 38 38 38 38 38 38 38 38 38 38 38 38 38 38 38 38 38                                
5 5 5 5 35 45 40 40 40 40 40 40 40 40 40 40 40 40 40 40 40 40 40 40 40 40 40 40 40 40 40 40 40 40 40 40 40 40 40 40 40 44 5 5 5 35 5 5 5 5 5 5 5 5 5 5 5 5 5 5 5 5 5 5                                
5 5 5 5 35 54 42 42 42 42 42 43 40 41 42 42 42 42 42 42 42 42 42 42 42 43 40 41 55 55 55 55 55 55 55 55 55 55 55 43 40 44 5 5 5 35 5 5 5 5 5 5 5 5 5 5 5 5 5 5 5 5 5 5                                
5 5 5 5 37 33 33 33 33 33 34 45 40 53 61 62 62 62 62 62 63 32 38 38 33 45 40 53 38 38 38 34 5 5 5 5 5 5 5 45 40 44 5 5 5 35 5 5 5 5 5 5 5 5 5 5 5 5 5 5 5 5 5 5                                
5 5 5 5 5 5 5 5 5 5 36 52 40 53 64 60 60 60 60 60 65 35 5 5 5 45 40 53 5 5 5 36 5 5 5 5 5 5 5 45 40 44 5 5 5 35 5 5 5 5 5 5 5 5 5 5 5 5 5 5 5 5 5 5                                
5 5 5 5 32 33 33 33 33 33 39 52 40 53 64 60 60 60 60 60 65 35 5 5 5 45 40 53 5 5 5 36 5 5 5 5 5 5 5 45 40 44 5 5 5 35 5 5 5 5 5 5 5 5 5 5 5 5 5 5 5 5 5 5                                
5 5 5 5 35 49 47 47 47 47 47 48 40 53 64 60 60 60 60 60 65 35 5 5 5 45 40 53 5 5 5 36 5 5 5 5 5 5 5 45 40 44 5 5 5 35 5 5 5 5 5 5 5 5 5 5 5 5 5 5 5 5 5 5                                
5 5 5 5 35 45 40 40 40 40 40 40 40 53 64 60 60 60 60 60 65 35 5 5 5 45 40 53 5 5 5 36 5 5 5 5 5 5 5 45 40 44 5 5 5 35 5 5 5 5 5 5 5 5 5 5 5 5 5 5 5 5 5 5                                
5 5 5 5 35 54 42 42 42 42 42 42 55 56 66 67 67 67 67 67 68 35 5 5 5 45 40 53 5 5 5 36 5 5 5 5 5 5 5 45 40 44 5 5 5 35 5 5 5 5 5 5 5 5 5 5 5 5 5 5 5 5 5 5                                
5 5 5 5 59 38 38 38 38 38 38 38 38 38 38 38 38 38 38 38 38 58 5 5 5 45 40 53 5 5 5 36 5 5 5 5 5 5 5 45 40 44 5 5 5 35 5 5 5 5 5 5 5 5 5 5 5 5 5 5 5 5 5 5                                
5 5 5 5 35 5 101 102 102 102 102 102 102 102 102 103 5 5 5 5 5 35 5 5 5 54 55 56 5 5 5 36 5 5 5 5 5 5 5 45 40 44 5 5 5 35 5 5 5 5 5 5 5 5 5 5 5 5 5 5 5 5 5 5                                
5 5 5 5 35 5 97 92 92 92 92 92 92 92 92 105 5 5 5 5 5 37 38 38 38 38 38 38 38 38 38 39 5 5 5 5 5 5 5 45 40 44 5 5 5 35 5 5 5 5 5 5 5 5 5 5 5 5 5 5 5 5 5 5                                
5 5 5 5 35 5 97 92 92 92 92 92 92 92 92 105 5 5 5 5 5 5 5 5 5 5 5 5 5 5 5 5 5 5 5 5 5 5 5 45 40 44 5 5 5 35 5 5 5 5 5 5 5 5 5 5 5 5 5 5 5 5 5 5                                
5 5 5 5 35 5 104 92 92 92 92 92 92 92 92 98 103 5 5 5 5 5 5 5 5 5 5 5 5 5 5 5 5 5 5 5 5 5 5 45 40 44 5 5 5 35 5 5 5 5 5 5 5 5 5 5 5 5 5 5 5 5 5 5                                
5 5 5 5 35 5 106 107 107 107 107 95 92 92 92 92 98 103 5 5 5 5 5 5 5 5 5 5 5 5 5 5 5 5 5 5 5 5 5 45 40 44 5 5 5 35 5 5 5 5 5 5 5 5 5 5 5 5 5 5 5 5 5 5                                
5 5 5 5 59 33 33 33 33 33 34 104 92 92 92 92 92 98 103 5 5 5 5 5 5 5 5 5 5 5 5 5 5 5 5 5 5 5 5 45 40 44 5 5 5 35 5 5 5 5 5 5 5 5 5 5 5 5 5 5 5 5 5 5                                
5 5 5 5 35 5 5 5 5 5 36 104 92 92 92 92 92 92 96 5 5 5 5 5 5 5 5 5 5 5 5 5 5 5 5 5 5 5 5 45 40 44 5 5 5 35 5 5 5 5 5 5 5 5 5 5 5 5 5 5 5 5 5 5                                
5 5 5 5 35 5 5 5 5 5 5 104 92 92 92 92 92 92 96 5 5 5 5 5 5 5 5 5 5 5 5 5 5 5 5 5 5 5 5 45 40 44 5 5 5 35 5 5 5 5 5 5 5 5 5 5 5 5 5 5 5 5 5 5                                
5 5 5 5 35 5 5 5 5 5 5 104 92 92 92 92 92 92 98 103 5 5 5 5 5 5 5 5 5 5 5 5 5 5 5 5 5 5 5 45 40 44 5 5 5 35 5 5 5 5 5 5 5 5 5 5 5 5 5 5 5 5 5 5                                
5 5 5 5 35 5 5 5 5 5 5 104 92 92 92 92 92 92 92 105 5 5 5 5 5 5 5 5 5 5 5 5 5 5 5 5 5 5 5 45 40 44 5 5 5 35 5 5 5 5 5 5 5 5 5 5 5 5 5 5 5 5 5 5                                
5 5 5 5 35 5 5 5 5 5 36 104 92 92 92 92 92 92 92 105 5 5 5 5 5 5 5 5 5 5 5 5 5 5 5 5 5 5 5 45 40 44 5 5 5 35 5 5 5 5 5 5 5 5 5 5 5 5 5 5 5 5 5 5                                
5 5 5 5 59 38 38 38 38 38 39 104 92 92 92 92 92 92 92 105 5 5 5 5 5 5 5 5 5 5 5 5 5 5 5 5 5 5 5 45 40 44 5 5 5 35 5 5 5 5 5 5 5 5 5 5 5 5 5 5 5 5 5 5                                
5 5 5 5 35 5 5 5 5 101 102 100 92 92 92 92 92 92 92 105 5 5 5 5 5 5 5 5 5 5 5 5 5 5 5 5 5 5 5 45 40 44 5 5 5 35 5 5 5 5 5 5 5 5 5 5 5 5 5 5 5 5 5 5                                
5 5 5 5 35 5 5 5 5 97 92 92 92 92 92 92 92 93 107 108 5 5 5 5 5 5 5 5 5 5 5 5 5 5 5 5 5 5 5 45 40 44 5 5 5 35 5 5 5 5 5 5 5 5 5 5 5 5 5 5 5 5 5 5                                
5 5 5 5 35 5 5 5 5 106 107 107 107 107 107 107 107 108 5 5 5 5 5 5 5 5 5 5 5 5 5 5 5 5 5 5 5 5 5 45 40 44 5 5 5 35 5 5 5 5 5 5 5 5 5 5 5 5 5 5 5 5 5 5                                
5 5 5 5 35 5 5 5 5 5 5 5 5 5 5 5 5 5 5 5 5 5 5 5 5 5 5 5 5 5 5 5 5 5 5 5 5 5 5 45 40 44 5 5 5 35 5 5 5 5 5 5 5 5 5 5 5 5 5 5 5 5 5 5                                
5 5 5 5 35 5 5 5 5 5 5 5 5 5 5 5 5 5 5 5 5 5 5 5 5 5 5 5 5 5 5 5 5 5 5 5 5 5 5 45 40 44 5 5 5 35 5 5 5 5 5 5 5 5 5 5 5 5 5 5 5 5 5 5                                
5 5 5 5 37 38 38 38 38 38 38 38 38 38 38 38 38 38 38 38 38 38 38 38 38 38 38 38 38 38 38 38 38 38 38 38 38 38 38 5 5 5 38 38 38 58 5 5 5 5 5 5 5 5 5 5 5 5 5 5 5 5 5 5                                
5 5 5 5 5 5 5 5 5 5 5 5 5 5 5 5 5 5 5 5 5 5 5 5 5 5 5 5 5 5 5 5 5 5 5 5 5 5 5 5 5 5 5 5 5 35 5 5 5 5 5 5 5 5 5 5 5 5 5 5 5 5 5 5                                
5 5 5 5 5 5 5 5 5 5 5 5 5 5 5 5 5 5 5 5 5 5 5 5 5 5 5 5 5 5 5 5 5 5 5 5 5 5 5 5 5 5 5 5 5 35 5 5 5 5 5 5 5 5 5 5 5 5 5 5 5 5 5 5                                
5 5 5 5 5 5 5 5 5 5 5 5 5 5 5 5 5 5 5 5 5 5 5 5 5 5 5 5 5 5 5 5 5 5 5 5 5 5 5 5 5 5 5 5 5 5 5 5 5 5 5 5 5 5 5 5 5 5 5 5 5 5 5 5                                
5 5 5 5 5 5 5 5 5 5 5 5 5 5 5 5 5 5 5 5 5 5 5 5 5 5 5 5 5 5 5 5 5 5 5 5 5 5 5 5 5 5 5 5 5 5 5 5 5 5 5 5 5 5 5 5 5 5 5 5 5 5 5 5                                
5 5 5 5 5 5 5 5 5 5 5 5 5 5 5 5 5 5 5 5 5 5 5 5 5 5 5 5 5 5 5 5 5 5 5 5 5 5 5 5 5 5 5 5 5 5 5 5 5 5 5 5 5 5 5 5 5 5 5 5 5 5 5 5                                
5 5 5 5 5 5 5 5 5 5 5 5 5 5 5 5 5 5 5 5 5 5 5 5 5 5 5 5 5 5 5 5 5 5 5 5 5 5 5 5 5 5 5 5 5 5 5 5 5 5 5 5 5 5 5 5 5 5 5 5 5 5 5 5                                
5 5 5 5 5 5 5 5 5 5 5 5 5 5 5 5 5 5 5 5 5 5 5 5 5 5 5 5 5 5 5 5 5 5 5 5 5 5 5 5 5 5 5 5 5 5 5 5 5 5 5 5 5 5 5 5 5 5 5 5 5 5 5 5                                
5 5 5 5 5 5 5 5 5 5 5 5 5 5 5 5 5 5 5 5 5 5 5 5 5 5 5 5 5 5 5 5 5 5 5 5 5 5 5 5 5 5 5 5 5 5 5 5 5 5 5 5 5 5 5 5 5 5 5 5 5 5 5 5                                
5 5 5 5 5 5 5 5 5 5 5 5 5 5 5 5 5 5 5 5 5 5 5 5 5 5 5 5 5 5 5 5 5 5 5 5 5 5 5 5 5 5 5 5 5 5 5 5 5 5 5 5 5 5 5 5 5 5 5 5 5 5 5 5                                
5 5 5 5 5 5 5 5 5 5 5 5 5 5 5 5 5 5 5 5 5 5 5 5 5 5 5 5 5 5 5 5 5 5 5 5 5 5 5 5 5 5 5 5 5 5 5 5 5 5 5 5 5 5 5 5 5 5 5 5 5 5 5 5                                
5 5 5 5 5 5 5 5 5 5 5 5 5 5 5 5 5 5 5 5 5 5 5 5 5 5 5 5 5 5 5 5 5 5 5 5 5 5 5 5 5 5 5 5 5 5 5 5 5 5 5 5 5 5 5 5 5 5 5 5 5 5 5 5                                
5 5 5 5 5 5 5 5 5 5 5 5 5 5 5 5 5 5 5 5 5 5 5 5 5 5 5 5 5 5 5 5 5 5 5 5 5 5 5 5 5 5 5 5 5 5 5 5 5 5 5 5 5 5 5 5 5 5 5 5 5 5 5 5                                
5 5 5 5 5 5 5 5 5 5 5 5 5 5 5 5 5 5 5 5 5 5 5 5 5 5 5 5 5 5 5 5 5 5 5 5 5 5 5 5 5 5 5 5 5 5 5 5 5 5 5 5 5 5 5 5 5 5 5 5 5 5 5 5                                
5 5 5 5 5 5 5 5 5 5 5 5 5 5 5 5 5 5 5 5 5 5 5 5 5 5 5 5 5 5 5 5 5 5 5 5 5 5 5 5 5 5 5 5 5 5 5 5 5 5 5 5 5 5 5 5 5 5 5 5 5 5 5 5                                
5 5 5 5 5 5 5 5 5 5 5 5 5 5 5 5 5 5 5 5 5 5 5 5 5 5 5 5 5 5 5 5 5 5 5 5 5 5 5 5 5 5 5 5 5 5 5 5 5 5 5 5 5 5 5 5 5 5 5 5 5 5 5 5                                
5 5 5 5 5 5 5 5 5 5 5 5 5 5 5 5 5 5 5 5 5 5 5 5 5 5 5 5 5 5 5 5 5 5 5 5 5 5 5 5 5 5 5 5 5 5 5 5 5 5 5 5 5 5 5 5 5 5 5 5 5 5 5 5                                
5 5 5 5 5 5 5 5 5 5 5 5 5 5 5 5 5 5 5 5 5 5 5 5 5 5 5 5 5 5 5 5 5 5 5 5 5 5 5 5 5 5 5 5 5 5 5 5 5 5 5 5 5 5 5 5 5 5 5 5 5 5 5 5                                
5 5 5 5 5 5 5 5 5 5 5 5 5 5 5 5 5 5 5 5 5 5 5 5 5 5 5 5 5 5 5 5 5 5 5 5 5 5 5 5 5 5 5 5 5 5 5 5 5 5 5 5 5 5 5 5 5 5 5 5 5 5 5 5                                
5 5 5 5 5 5 5 5 5 5 5 5 5 5 5 5 5 5 5 5 5 5 5 5 5 5 5 5 5 5 5 5 5 5 5 5 5 5 5 5 5 5 5 5 5 5 5 5 5 5 5 5 5 5 5 5 5 5 5 5 5 5 5 5                                
                                                                                                                                                               
                                                                                                                                                               
                                                                                                                                                               
                                                                                                                                                               
                                                                                                                                                               
                                                                                                                                                               
                                                                                                                                                               
